0000000000000
0000000000000
mpMcIC0000000
0000000000000
0010000000000
0000000000000